30 20
##############################
#         ######             #
#         ######             #
#         ######             #
#                            #
#                            #
#                   ##########
#######             ##########
#######             ##########
#######             ##########
#                   ##########
#                            #
#                            #
#                            #
#       ##############       #
#       ##############       #
#       ##############       #
#       ##############       #
#       ##############       #
##############################